
SO ./Textures/purple.xpm
      
    WE   ./Textures/stone_wall.xpm
C 0,50,225

EA      ./Textures/mossy_bricks.xpm

    NO ./Textures/eagle.xpm
F 100,220,0
11111111111
11000000001
11000000111
100011000E1
11111111111
