11111111111
1E0000000C1
11000C00111
1C0011000P1
11111111111
