
SO ./path_to_the_south_texture

    WE   ./path_to_the_west_texture
F 220,100,0

EA      ./path_to_the_east_texture

    NO ./path_to_the_north_texture

C 225,30,0

111111111111111111111111111111
100000000000000000000100000001
101E01010010000010100100010101
101001001010101000100100010101
100000000100110000000000000011
111111000111111111111111111111
1000000000000000000001
1010010100100000101001
1010010010101010001001
1000000001001100000011
1111111111111111111111
