
SO ./Textures/stone_bricks.xpm

    WE   ./Textures/red_bricks.xpm
F 100,220,0

EA      ./Textures/eagle.xpm

    NO ./Textures/mossy_bricks.xpm

C  0,50,225

111111111111111111111111111111
100000000000000000000100000001
101S01010010000010100100010101
101001001010101000100100010101
100000000100110000000000000011
111111001111111111111111111111
1010010010001010001001
1000000001001100000011
1010010100100000101001
1000000000000000000001
1111111111111111111111
